1111111111111111111111111
2222222222222222222222222
0000000000000000000000000
0000000000000000000000000
0000000000000000001000000
0000000000200000000000000
0000000000000000000000000
0000000000000000020000000
0000000000000000000000000
0000000001000000000000000
0000000000000000000100000
0000000000000000000000000
0000000000000000000000000
0000000000000010000002000
0000000000000000000000000
0000000000000000000000000
0000000000000000000000000
0000000000000000000000000
0000000010000000000000000
0000000000000000000000000
0000200000000000000000000
0000000000000200000000000
0000000000000000000000000
0000010000000000000000000
0000000000000000000000000
